#$$0#-----------w00$
#$0$#--p--------w000
#$0$w-----------w00$
#$$$w-----$-----w000
#$0$w----0$0----#$00
#0$$w----$0$----##00
#$$0w---wwwww---w0@0
#$00w---wwwww---w$00
#0$0w-----------w$0$
#$$0w-----$-----w$0$
#$$0w----0$-----w000
#0@0w----$$$----w000
#0@$w---$$0$----w000
#00$w--0$00$0---w00$
#$00w-00$$00$$--w0$0
#$00w00000$$00$-w$00
#$0$wwwwwwwwwwwww$$$
#$00$0$0$$00$$0$0$00
#00$0$00$$0$0000$00$
####################
