$$00---p-----0$$$##$
$$000-------00$#$0$0
0$0$#------0$$00$$$0
0$00$$-----##000$0$$
wwwwwwwww--wwwww$000
wwwwwwwww--wwwww0$$0
ww------------ww0$$0
ww------------ww0#00
ww------------ww$$$$
ww------------ww$00$
ww------------ww$00$
ww------------ww$00$
ww-----$$$----ww#0$0
ww----0$000---wwwwww
ww---$00$$00--wwwwww
ww--0000$$$$$$------
ww-0000$00$$0$ww$$#0
ww000$$0$$0000ww00$0
wwwwwwwwwwwwwwww$000
wwwwwwwwwwwwwwww0000